1111111111111111111111111111111
1C000000000000C00000000000000C1
1000000001001110111011110000001
1000000111001010101010010000001
1E00000001000010001000010000001
10000000P1000110011000010000001
1000000001000110011000010000001
10C0000001000010001000010000001
10000000010C101C10100001C000001
1000000011101110111000010000001
1000000000000000000000000000001
10000000000C000C000000000000001
10000000000C000C000000000000001
10C0000000000000000000000000C01
1000000000000000000000000000001
1111111111111111111111111111111