1111111111111111111111111111111
10001000000000C0000000000010001
1111100001001110111011110011111
10001001110010101E1010010010001
1000100001000010001000010010001
10001000P1000110011000010010001
1000100001000110011000010010001
10C0100001000010001000010010001
10001000010C101C10100001C010001
1000100011101110111000010010001
1000100000000000000000000010001
1000111111111111110111111110001
10000000000C000C000000000000001
10C0000000000000000000000000C01
1000000000000000000000000000001
1111111111111111111111111111111