11111111111111
1E0000000000P1
1C00C000000001
11111111111111