11111111111111
1E00000C0000P1
11111111111111